############
#....~~~~..#
#....~~~~..#
#..........#
#.......#..#
#..........#
############